0 0 0 0 0 0 0 0 0 0 0 0 0 0 0 0 0 0 0 0
0 0 0 0 0 0 0 0 0 0 0 0 0 0 0 0 0 0 0 0
0 0 0 0 0 0 0 0 0 0 0 0 0 0 0 0 0 77 78 78
0 0 0 0 0 0 0 0 0 0 0 0 0 0 0 0 0 76 74 75
0 0 0 0 0 0 0 0 0 0 0 0 0 0 0 0 0 76 73 0
0 0 0 0 0 0 0 0 0 0 0 0 0 0 0 0 0 76 73 0
0 0 0 0 0 0 0 0 0 0 0 0 0 1 2 2 3 76 73 0
0 0 0 0 0 0 0 0 0 0 0 0 0 0 0 0 0 76 73 0
0 0 0 0 0 0 0 0 0 0 0 0 0 0 0 0 0 76 73 0
0 0 0 0 0 0 0 1 2 2 2 3 0 0 0 64 65 66 72 0
7 0 0 1 2 2 2 5 5 5 5 6 0 0 0 80 81 82 1 2
2 2 2 5 5 5 5 5 5 5 5 5 5 5 5 5 5 5 5 5
5 5 5 5 5 5 5 5 5 5 5 5 5 5 5 5 5 5 5 5
5 5 5 5 5 5 5 5 5 5 5 5 5 5 5 5 5 5 5 5
5 5 5 5 5 5 5 5 5 5 5 5 5 5 5 5 5 5 5 5