0 0 0 0 0 0 0 0 0 0 0 58 60 58 0 0 0 0 0 0
0 0 0 0 0 0 60 61 61 61 61 61 59 61 61 61 61 61 60 0
0 0 0 0 0 0 0 0 0 0 58 58 60 58 58 0 0 0 0 0
0 0 0 0 0 0 0 0 0 0 12 12 60 12 12 0 0 0 0 0
0 0 0 0 0 0 0 0 0 0 12 12 60 12 12 0 0 0 0 0
0 0 0 0 0 0 0 0 0 0 12 12 60 12 12 0 0 0 0 0
0 0 0 0 0 0 0 0 0 0 12 12 60 12 12 0 0 0 0 0
0 0 0 0 0 0 0 0 0 0 12 12 61 12 12 0 0 0 0 0
0 0 0 0 0 0 0 0 0 0 12 12 12 12 12 0 0 0 0 0
0 0 0 0 0 0 0 0 0 0 12 12 12 12 12 0 0 0 0 0
0 0 0 0 0 0 0 0 0 29 12 12 14 12 12 29 0 0 0 0
7 0 57 57 57 57 57 57 57 4 2 2 2 2 2 6 57 57 0 7
2 2 2 2 2 2 2 2 2 5 5 5 5 5 5 5 2 2 2 2
5 5 5 5 5 5 5 5 5 5 5 5 5 5 5 5 5 5 5 5
5 5 5 5 5 5 5 5 5 5 5 5 5 5 5 5 5 5 5 5
