0 0 0 0 0 0 0 0 0 0 0 0 0 0 0 0 0 0 0 0
0 0 0 0 0 0 0 0 0 0 0 0 0 0 0 0 0 0 0 0
0 0 0 0 0 0 0 0 0 0 0 0 0 0 0 0 0 0 0 0
0 0 0 0 0 0 0 0 0 0 0 0 0 0 0 0 0 0 0 0
0 0 0 0 0 0 0 0 0 0 0 0 0 0 0 0 0 0 0 0
0 0 0 0 0 0 0 0 0 0 0 0 0 0 62 63 0 0 0 0
0 0 0 0 0 0 0 0 0 0 0 0 2 2 2 2 0 0 0 0
0 0 0 0 0 0 0 0 0 2 2 2 5 5 5 5 0 0 0 0
0 0 0 0 0 0 0 2 2 2 5 5 5 5 5 5 0 0 0 0
0 0 0 2 2 2 2 2 5 5 5 5 5 5 5 5 0 0 0 0
0 0 2 5 5 5 5 5 5 5 5 5 5 5 5 5 0 0 0 0
7 71 71 71 71 71 71 71 71 71 71 71 71 71 71 71 40 0 0 7
2 2 2 2 2 2 2 2 2 2 2 2 2 2 2 2 2 2 2 2
5 5 5 5 5 5 5 5 5 5 5 5 5 5 5 5 5 5 5 5
5 5 5 5 5 5 5 5 5 5 5 5 5 5 5 5 5 5 5 5