0 0 0 0 0 0 0 0 0 0 0 0 0 0 0 0 0 0 0 0
0 0 0 0 0 0 0 0 0 0 0 0 0 0 0 0 0 0 0 0
0 0 0 0 0 0 0 0 0 0 0 0 0 0 0 0 0 0 0 0
0 0 0 0 0 0 0 0 0 0 0 0 0 0 0 0 0 0 0 0
0 0 0 0 0 0 0 0 0 0 0 0 0 0 0 0 0 0 0 0
0 0 0 0 0 0 0 0 0 0 0 0 0 0 0 0 0 0 0 0
0 0 0 0 0 0 0 0 0 0 0 12 12 12 0 0 0 0 0 0
0 0 0 0 0 0 0 0 0 0 0 12 13 12 0 0 0 0 0 0
0 0 0 0 0 0 0 0 0 0 0 12 12 12 0 0 0 0 0 0
0 0 0 0 0 0 0 0 0 0 20 12 15 12 19 0 0 0 0 0
0 0 0 0 0 0 0 20 16 16 1 2 2 2 3 0 0 0 0 0
0 0 20 18 16 17 16 4 5 5 5 5 5 5 5 5 6 0 0 0
7 0 4 5 5 5 5 5 5 5 5 5 5 5 5 5 5 6 0 0
5 5 5 5 5 5 5 5 5 5 5 5 5 5 5 5 5 5 5 6
5 5 5 5 5 5 5 5 5 5 5 5 5 5 5 5 5 5 5 5
