0 0 0 0 0 0 0 0 0 0 0 0 0 0 0 0 0 0 0 0
0 0 0 0 0 0 0 0 0 0 0 0 0 0 0 0 0 0 0 0
0 0 0 0 0 0 0 0 0 0 0 0 0 0 0 0 0 0 0 0
0 0 0 0 0 0 0 0 0 0 0 0 0 0 0 0 0 0 0 0
0 0 0 0 0 0 0 0 0 0 0 0 38 0 0 0 0 0 0 0
0 0 0 0 0 0 0 0 0 0 0 36 39 37 0 0 0 0 0 0
0 0 0 0 0 0 0 0 0 0 0 12 12 12 0 0 0 0 0 0
0 0 0 0 0 0 0 0 0 0 0 12 13 12 0 0 0 0 0 0
0 0 0 0 0 0 0 0 0 0 0 12 12 12 0 0 0 0 0 0
0 0 0 0 0 0 0 0 0 0 0 12 12 12 22 23 24 0 0 0
0 0 0 0 0 0 0 20 16 16 16 12 15 12 0 21 0 0 0 0
0 0 20 18 16 17 16 4 5 5 5 5 5 5 5 5 6 0 0 0
0 0 4 5 5 5 5 5 5 5 5 5 5 5 5 5 5 6 0 7
5 5 5 5 5 5 5 5 5 5 5 5 5 5 5 5 5 5 5 6
5 5 5 5 5 5 5 5 5 5 5 5 5 5 5 5 5 5 5 5
