0 0 0 0 0 0 0 0 0 0 0 0 0 0 0 0 0 0 0 0
0 0 0 0 0 0 0 0 0 0 0 0 0 0 0 0 0 0 0 0
0 0 0 0 0 0 0 0 0 0 0 0 0 0 0 0 0 0 0 0
0 0 0 0 0 0 0 0 0 0 0 0 0 0 0 0 0 0 0 0
0 0 0 0 0 0 0 0 0 0 0 0 0 0 0 0 0 0 0 0
0 0 0 0 0 0 0 0 0 0 0 0 0 0 0 0 0 0 0 0
0 0 0 0 0 0 0 0 0 0 0 12 12 12 0 0 0 0 0 0
0 0 0 0 0 0 0 0 0 0 0 12 13 12 0 0 0 0 0 0
0 0 0 0 0 0 0 0 0 0 0 12 12 12 0 0 0 0 0 0
0 0 0 0 0 0 0 0 0 0 20 12 15 12 19 0 0 0 0 0
0 0 0 0 0 0 0 0 0 0 1 2 2 2 3 0 0 0 0 0
0 0 0 0 0 0 0 0 0 0 0 0 0 0 0 0 0 0 0 0
0 0 1 2 3 0 0 0 0 0 0 0 0 0 0 0 0 0 0 0
0 0 4 5 6 0 0 0 0 0 0 0 0 0 20 20 16 17 19 7
2 2 5 5 5 2 2 2 2 2 2 2 2 2 2 2 2 2 2 2
