0 0 0 0 0 0 0 0 0 0 0 0 0 0 0 0 0 0 0 0
0 0 0 0 0 0 0 0 0 0 0 0 0 0 0 0 0 0 0 0
0 0 0 0 0 0 0 0 0 0 0 0 0 0 0 0 0 0 0 0
0 0 0 0 0 0 0 0 0 0 0 0 0 0 0 0 0 0 0 0
0 0 0 0 0 0 0 0 0 0 0 0 0 0 0 0 0 0 0 0
0 0 0 0 0 0 0 0 0 0 12 12 12 12 12 0 0 0 0 0
0 0 0 0 0 0 0 0 0 0 12 12 12 12 12 0 0 0 0 0
0 0 0 0 0 0 0 0 0 0 12 12 12 12 12 0 0 0 0 0
0 0 0 0 0 0 0 0 0 0 12 12 12 12 12 0 0 0 0 0
0 0 0 0 0 0 0 0 0 0 12 12 12 12 12 0 0 0 0 0
0 0 0 0 0 0 0 0 0 0 12 12 15 12 12 0 0 0 0 0
7 0 0 0 0 0 0 0 0 4 2 2 2 2 2 6 0 0 0 7
2 2 2 2 2 2 2 2 2 5 5 5 5 5 5 5 2 2 2 2
5 5 5 5 5 5 5 5 5 5 5 5 5 5 5 5 5 5 5 5
5 5 5 5 5 5 5 5 5 5 5 5 5 5 5 5 5 5 5 5
